_____1_7_
____4_8_1
__6_27___
________4
54__1_3__
__8__6_5_
__53_____
9______6_
____6_41_